index walkable canAttackOver actions
33 0 1 ""
34 0 1 ""
35 0 1 ""
36 0 1 ""
37 0 1 ""
38 0 1 ""
39 0 1 ""
40 0 1 ""
41 0 1 ""
42 0 1 ""
43 0 1 ""
44 0 1 ""
45 0 1 ""
46 0 1 ""
48 0 1 ""
49 0 1 ""
50 0 1 ""
51 0 1 ""
52 0 1 ""
53 0 1 ""
54 0 1 ""
55 0 1 ""
56 0 1 ""
57 0 1 ""
58 0 1 ""
59 0 1 ""
73 0 0 ""
74 0 0 ""
75 0 0 ""
76 0 0 ""
77 0 0 ""
78 0 0 ""
80 0 0 ""
81 0 0 ""